9 12
------------
-________B_-
-_M__|__$$_-
-___+++++_--
-___+++++_--
-___P_____--
-_____V___--
-_________--
---------$$$
