13 26
$$$$$$$$$$$$$$$$$$$$$$$$$$
$$$____________________$$$
$$$__________|_________$$$
$$$___>>>>_M___>>>>>_V_$$$
$$$+++_________________$$$
$$$++++________________$$$
$$$+++++_______________$$$
$$$++++________________$$$
$$$+++_________________$$$
$$$+++_________________$$$
$$$_______________P____$$$
--------------------------
--------------------------
