10 10
----------
-________-
-_____M__-
-________-
-___PV___-
-_B__|___-
-________-
-________-
-________-
----------
