9 10
----------
-________-
-_M__|___-
-________-
-_______--
-___P___--
-_______--
-_______--
---------$
