13 26
$$$$$$$$$$$$$$$$$$$$$$$$$$
$$$____________________$$$
$$$__________|_________$$$
$$$___----_M___-----_V_$$$
$$$+++--------------___$$$
$$$+++--------------___$$$
$$$+++--------------___$$$
$$$+++--------------___$$$
$$$+++--------------___$$$
$$$___--------------___$$$
$$$_______________P____$$$
$$$____________________$$$
$$$$$$$$$$$$$$$$$$$$$$$$$$
